Понедельник=Понедељак
Вторник=Уторак
Четверг=Четвртак (Četvrtak)
Пятница=Петак (Petak)
Воскресенье=Недеља (Nedelja)
Выходные=Викенд (Vikend)
#Будни

0=nula (нула)
1=jedan (један)
2=dva (два)
3=tri (три)
4=četiri (четири)
5=pet (пет)
6=šest (шест)
7=sedam (седам)
8=osam (осам)
9=devet (девет)
10=deset (десет)
11=jedanaest (једанаест)
12=dvanaest (дванаест)
13=trinaest (тринаест)
14=četrnaest (четрнаест)
15=petnaest (петнаест)
16=šesnaest (шеснаест)
17=sedamnaest (седамнаест)
18=osamnaest (осамнаест)
19=devetnaest (деветнаест)
20=dvadeset (двадесет)
30=trideset (тридесет)
40=četrdeset (четрдесет)
50=pedeset (педесет)
60=šezdeset (шездесет)
70=sedamdeset (седамдесет)
80=osamdeset (осамдесет)
90=devedeset (деведесет)
400=četiristo (четиристо)
500=petsto (петсто)
600=šeststo (шестсто)
700=sedamsto (седамсто)
800=osamsto (осамсто)
900=devetsto (деветсто)
1000=hiljada (хиљада)

Месяца года=Месеци у години (Meseci u godini)
Январь=Јануар (Januar)
Февраль=Фебруар (Februar)
Март=Март (Mart)
Апрель=Април (April)
Май=Мај (Maj)
Июнь=Јун (Jun)
Июль=Јул (Jul)
Август=Август (Avgust)
Сентябрь=Септембар (Septembar)
Октябрь=Октобар (Oktobar)
Ноябрь=Новембар (Novembar)
Декабрь=Децембар (Decembar)
Месяц=Месец (Mesec)
Год=Година (Godina)

Спокойной ночи!=Лаку ноћ (Laku noć)
Привет!=Здраво (Zdravo)
Как дела?=Како си? (Kako si)
Хорошо, спасибо=Добро, хвала (Dobro, hvala)
Повторите, пожалуйста=Молим Вас, поновите (Molim Vas, ponovite)
Снова=Опет (Opet)
Что вы сказали?=Шта сте рекли? (Šta ste rekli)
Вы говорите по-английски?=Да ли говорите енглески? (Da li govorite engleski)
Вы говорите по-русски?=Да ли говорите руске? (Da li govorite ruske)

День рождения=Рођендан (Rođendan)
Годовщина=Годишњица (Godišnjica)
Праздник=Празник (Praznik)
Похороны=Сахрана (Sahrana)
Выпускной=Дипломирање (Diplomiranje)
Свадьба=Венчање (Venčanje)
С новым годом=Срећна Нова година! (Srećna Nova godina)
С днем рождения!=Срећан рођендан (Srećan rođendan)
Поздравляю!=Честитам (Čestitam)
Удачи!=Срећно (Srećno)
Подарок=Поклон (Poklon)
Вечеринка=Забава (Zabava)
Празднование=Прослава (Proslava)
Музыка=Музика (Muzika)

Любовь=Љубав (Ljubav)
Доверие=Поверење (Poverenje)
Уважение=Поштовање (Poštovanje)
Дружба=Пријатељство (Prijateljstvo)
Добро пожаловать!=Добродошли (Dobrodošli)
Простите=Пардон (Pardon)

Счастливый=Срећан (Srećan)
Печальный=Тужан (Tužan)
Злой=Љут (Ljut)
Напуганный=Уплашен (Uplašen)
Радость=Радост (Radost)
Удивлённый=Изненађен (Iznenađen)
Спокойствие=Смирен (Smiren)
Живой=Жив (Živ)
Мертвый=Мртав (Mrtav)
Одинокий=Сам (Sam)
Вместе=Заједно (Zajedno)
Скучающий=Досадно му је (Dosadno mu je)
Легко=Лак (Lak)
Трудный=Тежак (Težak)
Плохой=Лош (Loš)
Хорошо=Добар (Dobar)
Мне жаль=Жао ми је (Žao mi je)
Не волнуйтесь=Не брините (Ne brinite)

Карандаш=Оловка (Olovka)
Точилка=Резач за оловке (Rezač za olovke)
Ручка=Хемијска оловка (hemijska olovka)
Ножницы=Маказе (Makaze)
Книга=Књига (Knjiga)
Бумага=Папир (Papir)
Блокнот=Свеска (Sveska)
Папка=Фасцикла (Fascikla)
Линейка=Лењир (Lenjir)
Клей=Лепак (Lepak)
Ластик=Гумица (Gumica)
Контейнер для еды=Кутија за ручак (Kutija za ručak)
#Рюкзак

Доска=Школска табла (Školska tabla)
Письменный стол=Радни сто (Radni sto)
Табель успеваемости=Књижица (Knjižica)
Год обучения=Разред (Razred)
Класс=Учионица (Učionica)
Ученик=Ученик (Učenik)
Флаг=Застава (Zastava)
Свет=Светло (Svetlo)
Мне нужна ручка=Треба ми хемијска оловка (Treba mi hemijska olovka)
Мне нужно найти карту=Морам да нађем мапу (Moram da nađem mapu)
Где ножницы?=Где су маказе? (Gde su makaze)

Математика=Математика (Matematika)
Наука=Наука (nauka)
История=Историја (Istorija)
Чтение=Читање (Čitanje)
Письмо=Писање (Pisanje)
Музыка=Музичко (Muzičko)
Иностранный язык=Страни језик (Strani jezik)
География=Географија (Geografija)
Искусство=Ликовно (Likovno)
Биология=Биологија (Biologija)
Физика=Физика (Fizika)

Цвет=Боја (Boja)
Черный=Црна (Crna)
Синий=Плава (Plava)
Коричневый=Браон (Braon)
Зеленый=Зелена (Zelena)
Оранжевый=Наранџаста (Narandžasta)
Фиолетовый=Љубичаста (Ljubičasta)
Красный=Црвена (Crvena)
Белый=Бела (Bela)
Желтый=Жута (Žuta)
Серый=Сива (Siva)
Золотистый=Златна (Zlatna)
Серебристый=Сребрна (Srebrna)
Какого цвета?=Које је боје (Koje je boje)
Красного цвета=Црвене је боје (Crvene je boje)

Вулкан=Вулкан (Vulkan)
Каньон=Кањон (Kanjon)
Лес=Шума (Šuma)
Джунгли=Џунгла (Džungla)
Болото=Мочвара (Močvara)
Гора=Планина (Planina)
Горный хребет=Планински венац (Planinski venac)
Холм=Брдо (Brdo)
Водопад=Водопад (Vodopad)
Река=Река (Reka)
Озеро=Језеро (Jezero)
Пустыня=Пустиња (Pustinja)
Полуостров=Полуострво (Poluostrvo)
Остров=Острво (Ostrvo)
Пляж=Плажа (Plaža)
Океан=Океан (Okean)
Море=Море (More)
Залив=Залив (Zaliv)
Побережье=Обала (Obala)

Галактика=Галаксија (Galaksija)
Звезда=Звезда (Zvezda)
Луна=Месец (Mesec)
Планета=Планета (Planeta)
Астероид=Астероид (Asteroid)
Комета=Комета (Kometa)
Метеорит=Метеор (Meteor)
Космос=Свемир (Svemir)
Вселенная=Универзум (Univerzum)
Телескоп=Телескоп (Teleskop)
Солнечная система=Сунчев систем (Sunčev sistem)
Солнце=Сунце (Sunce)
Закат=Залазак сунца (Zalazak sunca)

Времена года=Годишња доба (Godišnja doba)
Зима=Зима (Zima)
Лето=Лето (Leto)
Весна=Пролеће (Proleće)
Осень=Јесен (Jesen)
Небо=Небо (Nebo)
Облако=Облак (Oblak)
Радуга=Дуга (Duga)
Холодная (погода)=Хладно (Hladno)
Жаркая (погода)=Вруће (Vruće)
Жарко=Вруће је (Vruće je)
Холодно=Хладно је (Hladno je)
Солнечно=Сунчано је (Sunčano je)
Облачно=Облачно је (Oblačno je)
Влажно=Влажно је (Vlažno je)
Идет дождь=Пада киша (Pada kiša)
Идет снег=Пада снег (Pada sneg)
Ветрено=Ветровито је (Vetrovito je)
Какая погода?=Какво је време? (Kakvo je vreme)
Хорошая погода=Лепо време (Lepo vreme)
Плохая погода=Ружно време (Ružno vreme)
Какая температура?=Колика је температура? (Kolika je temperatura)
На улице 24 градуса=Има 24 степена (Ima 24 stepena)

Катание на велосипеде=Бициклизам (Biciklizam)
Футбол=Фудбал (Fudbal)
Баскетбол=Кошарка (Košarka)
Волейбол=Одбојка (Odbojka)
Боулинг=Куглање (Kuglanje)
Катание на лыжах=Скијање (Skijanje)
Катание на коньках=Клизање на леду (Klizanje na ledu)
Бег=Трчање (Trčanje)
Бассейн=Базен (Bazen)
Солнечные очки=Наочаре за сунце (Naočare za sunce)
Полотенца=Пешкири (Peškiri)

Барабан=Бубањ (Bubanj)

Песок=Песак (Pesak)
Ведерко=Кофа (Kofa)
Лопата=Лопатица (Lopatica)
Мяч=Лопта (Lopta)
Я иду гулять=Идем у шетњу (Idem u šetnju)
Рыба=Риба (Riba)

Животные=Животиње (Životinje)
Кролик=Зец (Zec)
Курица=Кокошка (Kokoška)
Петух=Петао (Petao)
Лошадь=Коњ (Konj)
Цыпленок=Пиле (Pile)
Свинья=Свиња (Svinja)
Корова=Крава (Krava)
Овца=Овца (Ovca)
Козёл=Коза (Koza)
Лама=Лама (Lama)
Осёл=Магарац (Magarac)
Верблюд=Камила (Kamila)
Кошка=Мачка (Mačka)
Собака=Пас (Pas)
Мышь=Миш (Miš)
Лягушка=Жаба (Žaba)
Крыса=Пацов (Pacov)
Сарай=Амбар (Ambar)
Ферма=Фарма (Farma)

Черепаха=Корњача (Kornjača)
Обезьяна=Мајмун (Majmun)
Ящерица=Гуштер (Gušter)
Крокодил=Крокодил (Krokodil)
Летучая мышь=Слепи миш (Slepi miš)
Лев=Лав (Lav)
Тигр=Тигар (Tigar)
Слон=Слон (Slon)
Змея=Змија (Zmija)
Олень=Јелен (Jelen)
Белка=Веверица (Veverica)
Кенгуру=Кенгур (Kengur)
Бегемот=Нилски коњ (Nilski konj)
Жираф=Жирафа (Žirafa)
Лиса=Лисица (Lisica)
Волк=Вук (Vuk)
Медведь=Медвед (Medved)

Пчела=Пчела (Pčela)
Комар=Комарац (Komarac)
Паук=Паук (Pauk)
Кузнечик=Скакавац (Skakavac)
Оса=Оса (Osa)
Стрекоза=Вилин коњиц (Vilin konjic)
Червяк=Црв (Crv)
Бабочка=Лептир (Leptir)
Божья коровка=Бубамара (Bubamara)
Муравей=Мрав (Mrav)
Таракан=Бубашваба (Bubašvaba)
Жук=Буба (Buba)

Птица=Птица (Ptica)
Утка=Патка (Patka)
Павлин=Паун (Paun)
Ворон=Врана (Vrana)
Голубь=Голуб (Golub)
Индейка=Ћурка (Ćurka)
Гусь=Гуска (Guska)
Сова=Сова (Sova)
Страус=Ној (Noj)
Попугай=Папагај (Papagaj)
Аист=Рода (Roda)
Чайка=Галеб (Galeb)
Пингвин=Пингвин (Pingvin)
Лебедь=Лабуд (Labud)
Дятел=Детлић (Detlić)

Мать=Мајка (Majka)
Отец=Отац (Otac)
Брат=Брат (Brat)
Сестра=Сестра (Sestra)
Сын=Син (Sin)
Дочь=Ћерка (Ćerka)
Родители=Родитељи (Roditelji)
Дети=Деца (Deca)
Ребёнок=Дете (Dete)
Мачеха=Маћеха (Maćeha)
Отчим=Очух (Očuh)
Жена=Супруга (Supruga)
Муж=Супруг (Suprug)
Дедушка=Деда (Deda)
Бабушка=Баба (Baba)
Внук=Унук (Unuk)
Внучка=Унука (Unuka)
Внуки=Унучад (Unučad)
Родственник=Рођак (Rođak)
